#########################################
#        *         #                    #
# ***    ######    ######################
# *      #    #                         #
# *      #                      6       #
# ***    #    #  1          **          #
#        ######          ******         #
#        *         ###############      #
#     *********    #             #*     #
#        *    3    #             #*     #
####################             #*   9 #
                                 #      #
#########################################
